ANT = "countries/ANT.txt"
AFG = "countries/AFG.txt"
JES = "countries/JES.txt"
EJI = "countries/EJI.txt"
DOR = "countries/DOR.txt"
GAN = "countries/GAN.txt"
PPT = "countries/PPT.txt"
ISL = "countries/ISL.txt"
KUR = "countries/KUR.txt"
IRQ = "countries/IRQ.txt"
MOU = "countries/MOU.txt"
BKH = "countries/BKH.txt"
SHA = "countries/SHA.txt"
PNK = "countries/PNK.txt"
KRI = "countries/KRI.txt"
RAJ = "countries/RAJ.txt"
KZH = "countries/KZH.txt"
DVA = "countries/DVA.txt"
EBE = "countries/EBE.txt"
BYD = "countries/BYD.txt"
LET = "countries/LET.txt"
PLA = "countries/PLA.txt"
DVR = "countries/DVR.txt"
SIB = "countries/SIB.txt"
LAT = "countries/LAT.txt"
ELT = "countries/ELT.txt"
YAR = "countries/YAR.txt"
LUN = "countries/LUN.txt"
MRD = "countries/MRD.txt"
TUN = "countries/TUN.txt"
TRK = "countries/TRK.txt"
GBQ = "countries/GBQ.txt"
BSK = "countries/BSK.txt"
PRE = "countries/PRE.txt"
DUR = "countries/DUR.txt"
NRT = "countries/NRT.txt"
IPR = "countries/IPR.txt"
SKY = "countries/SKY.txt"
GVN = "countries/GVN.txt"
ABR = "countries/ABR.txt"
KIN = "countries/KIN.txt"
CKD = "countries/CKD.txt"
NAU =  "countries/NAU.txt"
BSV = "countries/Basvorchane.txt"
IZM = "countries/Izmailchane.txt"
CRM = "countries/Crimchane.txt"
KER = "countries/Kerchane.txt"
SIN = "countries/Sinopichi.txt"
ORD = "countries/Orduchi.txt"
PTC = "countries/Potichi.txt"
1AZ = "countries/VerhAzov.txt"
2AZ = "countries/ZahidniAzov.txt"
3AZ = "countries/ShidniAzov.txt"
HUY = "countries/govno.txt"
BUL = "countries/BUL.txt"
CZE = "countries/CZE.txt"
DDR = "countries/DDR.txt"
HIT = "countries/HIT.txt"
HOR = "countries/HOR.txt"
MAR = "countries/MAR.txt"
MUS = "countries/MUS.txt"
BNP = "countries/BNP.txt"
NAP = "countries/NAP.txt"
NEK = "countries/NEK.txt"
NIG = "countries/NIG.txt"
PAS = "countries/PAS.txt"
POP = "countries/POP.txt"
SAU = "countries/SAU.txt"
SRB = "countries/SRB.txt"
SWI = "countries/SWI.txt"
TRA = "countries/TRA.txt"
VAL = "countries/VAL.txt"
GDI = "countries/GDI.txt"
NOD = "countries/NOD.txt"
BAL = "countries/BAL.txt"
EST = "countries/EST.txt"
POL = "countries/POL.txt"
HOJ = "countries/HOJ.txt"
VEY = "countries/VEY.txt"
DNB = "countries/DNB.txt"
ZLS = "countries/ZLS.txt"
ZPU = "countries/ZPU.txt"
KIV = "countries/KIV.txt"
ROA = "countries/ROA.txt"
ODE = "countries/Odessa.txt"
CCA = "countries/CCA.txt"
TEM = "countries/TEM.txt"
POD = "countries/POD.txt"
MEE = "countries/MEE.txt"
RNS = "countries/RNS.txt"
MOS = "countries/MOS.txt"
BLO = "countries/BLO.txt"
GUL = "countries/GUL.txt"
TUC = "countries/TUC.txt"
OZO = "countries/OZO.txt"
ZMR = "countries/ZMR.txt"
SHY = "countries/SHY.txt"
GON = "countries/GON.txt"
UMO = "countries/UMO.txt"
HAR = "countries/HAR.txt"
ELF = "countries/ELF.txt"
DUD = "countries/DUD.txt"
ROC = "countries/ROC.txt"
CHE = "countries/Chechnya.txt"
BRK = "countries/barkov.txt"
PRA = "countries/pravos.txt"
RAP = "countries/casacs.txt"
CSS = "countries/Rap.txt"
NJS = "countries/nodejs'eri.txt"
KOL = "countries/kolhoz.txt"
CCT = "countries/CCT.txt"
UKE = "countries/UKE.txt"
CHR = "countries/Chernobyl.txt"
KEB = "countries/KEB.txt"
TSA = "countries/TSA.txt"
DUG = "countries/DUG.txt"
TAR = "countries/TAR.txt"
VNM = "countries/VNM.txt"
CNB = "countries/CNB.txt"
SAB = "countries/SAB.txt"
PLS = "countries/PLS.txt"
VKN = "countries/VKN.txt"
PRX = "countries/PRX.txt"
CUB = "countries/CUB.txt"

BAR = "countries/BAR.txt"
CRO = "countries/CRO.txt"
MRL = "countries/MRL.txt"
PRD = "countries/PRD.txt"
UCH = "countries/UCH.txt" #228
CHH = "countries/CHH.txt"
MUR = "countries/MUR.txt" 
TNH = "countries/TNH.txt"
N2N = "countries/N2N.txt"
MUH = "countries/MUH.txt" 
ZEK = "countries/ZEK.txt" 
JEW = "countries/JEW.txt" 
LTZ = "countries/LTZ.txt" 
MAH = "countries/MAH.txt"
EMO = "countries/EMO.txt"
HIP = "countries/HIP.txt"
KMI = "countries/KMI.txt"
UNR = "countries/UNR.txt"
MED = "countries/MED.txt"
STH = "countries/STH.txt"
KNR = "countries/KNR.txt" #Новые сибирские страны
MOD = "countries/MOD.txt"
BRJ = "countries/BRJ.txt"
YAK = "countries/YAK.txt"
BUG = "countries/BUG.txt"
WGA = "countries/WGA.txt"
BAD = "countries/BAD.txt"
STA = "countries/STA.txt"
KAZ = "countries/KAZ.txt"
SUS = "countries/SUS.txt"
SPA = "countries/SPA.txt"
KRT = "countries/KRT.txt"
GRE = "countries/GRE.txt"
SAV = "countries/SAV.txt"
PEC = "countries/PEC.txt"

DUM = "countries/DUM.txt"
PLR = "countries/PLR.txt"
BL9 = "countries/BLYATB.txt"
FCK = "countries/FUCKINGSLAVE.txt"
KOK = "countries/KAKASHKA.txt"
GOM = "countries/GOMOSEKS.txt"
NEM = "countries/NEM.txt"
SVT = "countries/SVT.txt"
FEM = "countries/FEM.txt"
PCY = "countries/PCY.txt"
OBS = "countries/OBS.txt"
LFR = "countries/LFR.txt"
GSA = "countries/GSA.txt"
VPU = "countries/VPU.txt"
ORS = "countries/ORS.txt"
OR1 = "countries/OR1.txt"
OR4 = "countries/OR4.txt"
OR5 = "countries/OR5.txt"
OR6 = "countries/OR6.txt"
OR7 = "countries/OR7.txt"
OR9 = "countries/OR9.txt"
O10 = "countries/O10.txt"
LNN = "countries/LNN.txt"
AFO = "countries/AFO.txt"